11 18
3 3 3 3 3 3 3 3 3 3 3 3 3 3 3 3 3 3
3 1 0 1 1 1 1 1 1 1 1 1 1 1 0 1 1 3
3 1 0 0 0 1 0 0 1 0 0 0 1 0 0 0 1 3
3 1 0 1 0 1 0 1 1 0 1 1 1 1 1 0 1 3
3 1 0 1 0 0 0 0 1 0 1 0 0 0 1 0 1 3
3 1 0 1 1 1 1 0 1 0 1 0 0 0 1 1 1 3
3 0 0 0 1 0 1 0 0 0 1 1 1 1 1 0 1 3
3 1 0 1 1 0 1 1 0 0 1 1 1 0 0 0 1 3
3 1 0 0 0 0 0 0 0 0 0 0 0 0 0 0 0 3
3 1 1 1 1 1 1 1 0 1 1 1 1 1 1 1 1 3
3 3 3 3 3 3 3 3 3 3 3 3 3 3 3 3 3 3
0
0 0 0 0 0 0 0 0 0 0 0 0 0 0 0 0 0 0
0 0 3 0 0 0 0 0 0 0 0 0 0 0 2 0 0 0
0 0 2 7 6 0 2 2 0 6 7 3 1 2 2 2 0 0
0 0 4 0 1 0 2 1 0 5 0 0 0 0 0 2 0 0
0 0 7 0 1 1 1 1 0 1 0 4 4 4 0 2 0 0
0 0 4 0 0 0 0 1 0 1 0 4 4 4 0 1 0 0
0 9 1 1 0 1 0 1 1 1 0 0 0 0 0 5 0 0
0 0 2 0 0 1 0 0 9 1 0 0 0 3 4 2 0 0
0 0 3 5 9 2 6 9 1 1 1 1 1 1 1 1 1 0
0 0 0 0 0 0 0 0 1 0 0 0 0 0 0 0 0 0
0 0 0 0 0 0 0 0 0 0 0 0 0 0 0 0 0 0
0
0 0 0 0 0 0 0 0 0 0 0 0 0 0 0 0 0 0
0 0 3 0 0 0 0 0 0 0 0 0 0 0 2 0 0 0
0 0 1 7 6 0 2 2 0 3 6 3 2 1 4 3 0 0
0 0 2 0 1 0 2 1 0 5 0 0 0 0 0 2 0 0
0 0 3 0 1 1 1 1 0 1 0 4 4 4 0 6 0 0
0 0 4 0 0 0 0 1 0 1 0 4 4 4 0 1 0 0
0 1 6 4 0 1 0 1 1 1 0 0 0 0 0 5 0 0
0 0 1 0 0 1 0 0 9 1 0 0 0 3 4 2 0 0
0 0 1 3 2 7 0 1 1 8 8 8 8 8 8 8 8 0
0 0 0 0 0 0 0 0 1 0 0 0 0 0 0 0 0 0
0 0 0 0 0 0 0 0 0 0 0 0 0 0 0 0 0 0
0
0 0 0 0 0 0 0 0 0 0 0 0 0 0 0 0 0 0
0 0 1 0 0 0 0 0 0 0 0 0 0 0 2 0 0 0
0 0 3 1 1 0 2 2 0 6 7 3 1 2 2 2 0 0
0 0 5 0 1 0 2 1 0 5 0 0 0 0 0 2 0 0
0 0 7 0 1 1 1 1 0 1 0 4 4 4 0 2 0 0
0 0 9 0 0 0 0 1 0 1 0 4 4 4 0 1 0 0
0 9 9 1 0 1 0 1 1 1 0 0 0 0 0 5 0 0
0 0 2 0 0 1 0 0 6 8 0 0 0 3 4 2 0 0
0 0 3 1 1 1 2 3 2 7 1 1 4 5 4 1 1 0
0 0 0 0 0 0 0 0 3 0 0 0 0 0 0 0 0 0
0 0 0 0 0 0 0 0 0 0 0 0 0 0 0 0 0 0
0
0 0 0 0 0 0 0 0 0 0 0 0 0 0 0 0 0 0
0 0 0 0 0 0 0 0 0 0 0 0 0 0 0 0 0 0
0 0 0 0 0 0 0 0 0 0 0 0 0 0 0 0 0 0
0 0 0 0 0 0 0 0 0 0 0 0 0 0 0 0 0 0
0 0 0 0 0 0 0 0 0 0 0 0 0 0 0 0 0 0
0 0 9 0 0 0 0 0 0 0 0 0 0 0 0 0 0 0
0 9 9 0 0 0 0 0 0 0 0 0 0 0 0 0 0 0
0 0 0 0 0 0 0 0 0 0 0 0 0 0 0 0 0 0
0 0 0 0 0 0 0 0 0 0 0 0 0 0 0 0 0 0
0 0 0 0 0 0 0 0 0 0 0 0 0 0 0 0 0 0
0 0 0 0 0 0 0 0 0 0 0 0 0 0 0 0 0 0